a	á
a.k.a.	a. k. a.
a.m.k	a.m.k.
a.mk.	a.m.k.
Adami	Adam
Adelie	Adele
adgerdaaaetlun	aðgerðaáætlun
adhd	ADHD
Adolfi	Adolf
afborgarnir	afborganir
afgangnum	afganginum
afram	áfram
Afrinhérað	Afrínhérað
Afrinhéraði	Afrínhéraði
afslappaðara	afslappaðra
afslappaðari	afslappaðri
afslátti	afslætti
afsökunnar	afsökunar
aftir	aftur
Aftonbladed	Aftonbladet
aftu	aftur
Aftuelding	Afturelding
aftúr	aftur
afur	aftur
afþreyingum	afþreyingu
agaðari	agaðri
aggressívur	agressívur
Agusta	Ágústa
ahfa	hafa
ahn	hann
ahnn	hann
akkurat	akkúrat
Akkurat	akkúrat
akkúrrat	akkúrat
akrílmálningu	akrýlmálningu
akstu	akstur
akstureiginleika	aksturseiginleika
aksturþjónustu	akstursþjónustu
aktivisma	aktívisma
aktivista	aktívista
aktivistar	aktívistar
aktivisti	aktívisti
Akureyar	Akureyrar
Alavítar	Alavítar
aldei	aldrei
aldrey	aldrei
aldrinu	aldrinum
Alexanda	Alexandra
Alexanderson	Alexandersson
Alexandr	Alexander
Alexandru	Alexöndru
Alexender	Alexander
Alexi	Alex
Alfreði	Alfreð
algegnt	algengt
algent	algengt
algör	algjör
alkahólisma	alkóhólisma
alkahólista	alkóhólista
alkahólisti	alkóhólisti
allaf	alltaf
allann	allan
allanvega	allavega
allataf	alltaf
allaveg	allavega
allaveganna	allavega
allavena	allavega
alldrei	aldrei
alllt	allt
allltaf	alltaf
allst	allt
allta	alltaf
almannaksárinu	almanaksárinu
almannatrygginar	almannatryggingar
Almarrs	Almars
almenningsamgangna	almenningssamganga
almennnings	almennings
alsherjar	allsherjar
alsráðandi	allsráðandi
altaf	alltaf
Althingi	Alþingi
althingis	alþingis
altjent	alltént
altlaf	alltaf
alvega	allavega
alþingsmaður	alþingismaður
alþjóðasamfélagins	alþjóðasamfélagsins
alþm	alþm.
amk	a.m.k.
amkvæmt	samkvæmt
ananans	ananas
ananr	annar
ananrs	annars
andstæðingin	andstæðinginn
andyri	anddyri
andyrinu	anddyrinu
Angólar	Angólamenn
annahvort	annaðhvort
annann	annan
annarar	annarrar
annari	annarri
annarr	annar
annarrra	annarra
annnan	annan
annnarra	annarra
annrs	annars
antik	antík
Apotek	Apótek
Apotekinu	Apótekinu
Argentísk	Argentínsk
argentíska	argentínska
Argentíska	Argentínska
argentíski	argentínski
Argentíski	Argentínski
arkmið	markmið
arkítekt	arkitekt
arkítekta	arkitekta
arkítektar	arkitektar
arkítektinn	arkitektinn
arkítektum	arkitektum
arkítektúr	arkitektúr
Arnarsd	Arnarsd.
arsemi	arðsemi
Arsskyrsla	Ársskýrsla
Artotek	Artótek
Aserbaídjan	Aserbaísjan
Asgeir	Ásgeir
Asger	Ásgeir
Asiu	Asíu
Así	ASÍ
ath	ath.
athugsemd	athugasemd
athugsemdakerfi	athugasemdakerfi
athugsemdir	athugasemdir
athugsemdum	athugasemdum
athygi	athygli
athylgi	athygli
atkv	atkv.
Atlandshafi	Atlantshafi
Atlandshafsbandalagið	Atlantshafsbandalagið
Atlandshafsbandalagsins	Atlantshafsbandalagsins
atvinnuli	atvinnulið
atvinnustarfssemi	atvinnustarfsemi
atvinnuþáttöku	atvinnuþátttöku
atvæði	atkvæði
Audur	Auður
auganum	auganu
augnæknis	augnlæknis
auking	aukning
aukingu	aukningu
aukis	aukist
aukð	aukið
austuhluta	austurhluta
Austuríki	Austurríki
austuríska	austurríska
auvðitað	auðvitað
auðugari	auðugri
auðvita	auðvitað
avokadó	avókadó
aðahlutverk	aðalhlutverk
aðahlutverki	aðalhlutverki
Aðalavalmynd	Aðalvalmynd
aðalleikona	aðalleikkona
Aðalleikona	Aðalleikkona
aðar	aðra
aðdragandum	aðdragandanum
aðeisn	aðeins
aðg	aðg.
aðgangnum	aðganginum
aðgerðinar	aðgerðirnar
aðiens	aðeins
aðillinn	aðilinn
aðins	aðeins
aðraganda	aðdraganda
aðskild	aðskilin
aður	áður
Aþingis	Alþingis
aþr	þar
B.Ed	B.Ed.
B.ed	B.Ed.
B.s.	B.S.
Babýlóns	Babýlons
Bakary	Bakery
bakarínu	bakaríinu
Bakkabraedur	Bakkabræður
bakkan	bakkann
Bandarikjanna	Bandaríkjanna
Bandarikjunum	Bandaríkjunum
Bandaríkaforseta	Bandaríkjaforseta
Bandaríkaforseti	Bandaríkjaforseti
Bandaríkinn	Bandaríkin
Bandaríkjana	Bandaríkjanna
Bandaríkjanan	Bandaríkjanna
Bandaríkjann	Bandaríkjanna
Bandaríkjdala	Bandaríkjadala
Bandaríkjunm	Bandaríkjunum
Bandaríkjunu	Bandaríkjunum
Bandaríkunum	Bandaríkjunum
Bandraíkjanna	Bandaríkjanna
Bankok	Bangkok
baraáttu	baráttu
Barelona	Barcelona
Barnaverndastofu	Barnaverndarstofu
barráttu	baráttu
Barðarströnd	Barðaströnd
barómeter	loftvog
basilika	basilíka
basiliku	basilíku
Begium	Belgium
Belgrað	Belgrad
bema	nema
Bendikt	Benedikt
Bendiktsson	Benediktsson
Bendiktssonar	Benediktssonar
Benediksson	Benediktsson
Benedikssonar	Benetiktssonar
Benedikti	Benedikt
Benedorm	Benidorm
bensínsstöð	bensínstöð
betir	betri
Beuty	Beauty
beyta	beita
beytt	beitt
bikaúrslitaleiknum	bikarúrslitaleiknum
billinu	bilinu
birist	birtist
birtisti	birtist
birtst	birtist
Bissá	Bissaú
Bió	Bíó
Bjarnasson	Bjarnason
Bjarndóttir	Bjarnadóttir
bjartvirði	bjartviðri
bjóstakrabbameini	brjóstakrabbameini
Björgvinn	Björgvin
Björku	Björk
Björvin	Björgvin
bls	bls.
Blöndósi	Blönduósi
Bodgan	Bogdan
boltan	boltann
boltin	boltinn
Borganesi	Borgarnesi
borgararinnar	borgarinnar
borgararkítekt	borgararkitekt
borgarfulltrúm	borgarfulltrúum
borgarinar	borgarinnar
borgarinnnar	borgarinnar
borgini	borginni
Bosporussund	Bospórussund
Bosporussundið	Bospórussundið
botnin	botninn
Bournmouth	Bournemouth
Brasílíu	Brasilíu
bregast	bregðast
bregaðst	bregðast
breiskleika	breyskleika
breyast	breytast
breystast	breytast
brids	bridds
briem	Briem
Brigthon	Brighton
Brigton	Brighton
Brittain	Britain
brjóstarhaldara	brjóstahaldara
brokkoli	brokkólí
brt	brt.
bráðabirgðarmeistari	bráðabirgðameistari
bráðabirgðartitilinn	bráðabirgðatitilinn
bráðabirða	bráðabirgða
bráðabrigða	bráðabirgða
bráðamótttöku	bráðamóttöku
bráðamótttökunni	bráðamóttökunni
bræðurnar	bræðurna
bróðurs	bróður
brúðurinn	brúðurin
Bugl	BUGL
Buisness	Business
bundar	bundnar
Byrkir	Birkir
byrunarliðinu	byrjunarliðinu
bárus	bárust
báráttu	baráttu
báráttunni	baráttunni
Bárðabungu	Bárðarbungu
Bárðarsson	Bárðarson
bátarins	bátsins
bátinum	bátnum
Báður	Bárður
bæjarsins	bæjarins
bæum	bæjum
bíllin	bíllinn
bókinn	bókin
Bólívíu	Bólivíu
bómul	bómull
börnun	börnum
börnunm	börnum
búlemíu	búlimía
Búlgarir	Búlgarar
Búlgörum	Búlgurum
búrkini	búrkiní
Búrkíníbannið	Búrkiníbannið
búrkíníið	búrkiníið
búrkíníum	búrkiníum
búrmíska	mjanmarska
búrmíski	mjanmarski
Búrmíski	Mjanmarski
búrmísku	mjanmörsku
Búsáhaldabyltingi	Búsáhaldabyltingin
dagins	dagsins
dagsfer	dagsferð
dagskra	dagskrá
Damörku	Danmörku
Danmörkur	Danmerkur
Dansiði	___
Daníeli	Daníel
darraðadans	darraðardans
Davíði	Davíð
Deanerys	Daenerys
debit	debet
deginu	deiginu
degið	deigið
deidlarinnar	deildarinnar
deiildinni	deildinni
deildarinanr	deildarinnar
deildarinar	deildarinnar
deildarinna	deildarinnar
deildini	deildinni
deildinn	deildinni
deildinnar	deildarinnar
Delevinge	Delevingne
Delhí	Delí
desemer	desember
desmber	desember
deyji	deyi
dieselbíla	dísilbíla
Diljáar	Diljár
Djíbjútí	Djibútí
dkr	d.kr.
doldið	dálítið
dramatúrgur	dramatúrg
draugi	draug
drengins	drengsins
dreyfa	dreifa
drog	drög
drottingar	drottningar
drykksins	drykkjarins
drógst	dróst
dróu	drógu
Dubaí	Dúbaí
Dyflinar	Dyflinnar
Dyflinarreglugerðarinnar	Dyflinnarreglugerðarinnar
Dyflinarreglugerðin	Dyflinnarreglugerðin
Dyflinarreglugerðina	Dyflinnarreglugerðina
Dyflinarreglugerðinni	Dyflinnarreglugerðinni
dálítíð	dálítið
dæmsi	dæmis
dísel	dísill
díselbifreiða	dísilbifreiða
díselbíla	dísilbíla
díselbílar	dísilbílar
díselbílum	dísilbílum
díselolía	dísilolía
díselolíu	dísilolíu
díselrafstöðvar	dísilrafstöðvar
díselrafstöðvum	dísilrafstöðvum
díselvél	dísilvél
díselvélar	dísilvélar
díselvélum	dísilvélar
Dóminikanska	Dóminíska
Dóminíkanska	Dóminíska
Dóminós	Dominos
dómsmálaráherra	dómsmálaráðherra
Dórothea	Dóróthea
Dóróthe	Dóróthea
dóttirinn	dóttirin
Dögunnar	Dögunar
dögunu	dögunum
döguðu	dagaði
dökklæddur	dökkklæddur
Dúbai	Dúbaí
Dúbæ	Dúbaí
dúettnum	dúettinum
e.a.	e-a
e.kr.	e.Kr.
e.t.v	e.t.v.
Eda	Eða
eda	eða
efh	ehf.
efitr	eftir
Efnhagsmál	Efnahagsmál
efnhagsráðherra	efnahagsráðherra
Efraim	Efraím
eft	eftir
Efta	EFTA
efti	eftir
eftirpurn	eftirspurn
eftirsóknaverður	eftirsóknarverður
eftispurn	eftirspurn
eftr	eftir
eftri	eftir
eftstu	efstu
eftur	eftir
efur	hefur
eg	ég
egar	þegar
Egilson	Egilsson
Egilsst	Egilsst.
Egilstaða	Egilsstaða
Egilstaði	Egilsstaði
Egilstöðum	Egilsstöðum
egir	segir
Eidur	Eiður
eigandanna	eigendanna
eigendi	eigandi
eimitt	einmitt
eimmitt	einmitt
Einarsdottir	Einarsdóttir
Einarsssonar	Einarssonar
einfaldega	einfaldlega
einfallt	einfalt
eingungis	einungis
eingögnu	eingöngu
einhvað	eitthvað
einhven	einhver
einhversslags	einhvers lags
einhvert	eitthvert
einingis	einungis
einkaðilar	einkaaðilar
einkunina	einkunnina
einkuninn	einkunnin
einng	einnig
einning	einnig
einnnig	einnig
einnrar	einnar
einsta	einasta
einstaklingins	einstaklingsins
einstalinga	einstaklinga
einstalingi	einstaklingi
einta	eintak
eintaklinga	einstaklinga
einugis	einungis
einunigs	einungis
einvherju	einhverju
eithvað	eitthvað
eitthver	einhver
eitthverjir	einhverjir
eitthvða	eitthvað
eittthvað	eitthvað
eittvað	eitthvað
Eiðnum	Eiðinum
eki	ekki
ekk	ekki
ekker	ekkert
ekkkert	ekkert
ekkki	ekki
ekstrarhagnaður	rekstrarhagnaður
elfd	efld
elft	eflt
Elliðárdalsins	Elliðaárdalsins
Emannuel	Emanuel
embæti	embætti
emiritus	emeritus
Emmsje	Emmsjé
Emmsé	Emmsjé
emætti	embætti
endan	endann
endurskodun	endurskoðun
engann	engan
Engann	Engan
Englendinum	Englendingum
engur	lengur
Eritreu	Erítreu
erle	erl.
Erlingdsdóttir	Erlingsdóttir
erm	erum
Ermolinskji	Ermolinskij
Ermonlinskij	Ermolinskij
Eríkur	Eiríkur
Esjberg	Esbjerg
essu	þessu
ethanóli	etanóli
etta	þetta
etv	e.t.v.
Eurovison	Eurovision
Eurovisonlagið	Eurovisionlagið
Evrest	Everest
evrópulögum	Evrópulögum
Evrópumeistarmótinu	Evrópumeistaramótinu
Evrópusambandins	Evrópusambandsins
evrópusæti	Evrópusæti
evrópusætið	Evrópusætið
Evróusambandsins	Evrópusambandsins
Evópu	Evrópu
Evópumótinu	Evrópumótinu
exel	Excel
Exel	Excel
Eyglóu	Eygló
eyjunna	eyjuna
eyrnarmerkt	eyrnamerkt
eyturlyfjaneyslu	eiturlyfjaneyslu
eðliegt	eðlilegt
f.Kr	f.Kr.
f.kr.	f.Kr.
f.v.	fv.
F.v.	fv.
fagurferði	fagurfræði
Fakó	FAKÓ
falleinkun	___
Fanndis	Fanndís
fanns	fannst
fanst	fannst
farandsfæti	faraldsfæti
fariði	friði
Fatimusjóðinn	Fatímusjóðinn
Fbl	Fbl.
feb	feb.
febr	febr.
fegurðasamkeppnir	fegurðarsamkeppnir
fekar	frekar
fekk	fékk
Felixsson	Felixson
fellibyli	fellibylji
fellibylir	fellibyljir
felstum	flestum
felt	fellt
feminisma	femínisma
feminismi	feminismi
feminista	femínista
feministar	femínistar
feministi	femínisti
feministiska	feminíska
feministum	femínistum
Feminísk	Feminísk
femínisk	feminísk
femíniska	feminísk
fengar	fengnar
fengð	fengið
ferkar	frekar
ferkst	ferskt
fermeter	fermetri
ferðamannastrauminum	ferðamannastraumnum
ferðaþjónstu	ferðaþjónustu
ferðaþjónstunnar	ferðaþjónustunnar
ferðaþjónstunni	ferðaþjónustunni
ferðaþónustu	ferðaþjónustu
ferði	verði
ferðlag	ferðalag
ferðlagi	ferðalagi
ferðlagið	ferðalagið
ferðlög	ferðalög
ferðlögum	ferðalögum
ferðmanna	ferðamanna
ferðmaður	ferðamaður
ferðmenn	ferðamenn
ferðmönnum	ferðamönnum
ferðþjónustu	ferðaþjónustu
ferðþjónustunnar	ferðaþjónustunnar
festst	fest
feyknagóð	feiknagóð
feyknasterku	feiknasterku
feðgininum	feðginunum
fftl	fftl.
FHingar	FH-ingar
Filippeysk	Filippseysk
filippeysk	filippseysk
filippeyska	filippseyska
Filippeyski	Filippseyski
filippeyskra	filippseyskra
filippeysku	filippseysku
filippeyskum	filippseyskum
Filipseyinga	Filippseyinga
Filipseyja	Filippseyja
Filipseyjar	Filippseyjar
Filipseyjum	Filippseyjum
filistea	fílistea
Fillipseyjum	Filippseyjum
fimtán	fimmtán
fin	fín
fingu	fingur
Finlandi	Finnlandi
finndi	fyndi
finndist	fyndist
Finnson	Finnsson
Finsson	Finnsson
fir	yfir
Fjarðab	Fjarðab.
Fjelsted	Fjeldsted
fjá	fá
fjámunum	fjármunum
Fjámálaeftirlitið	Fjármálaeftirlitið
fjárfestingakosts	fjárfestingarkostar
Fjármálaeftirlitisins	Fjármálaeftirlitsins
fjármálafyrirækja	fjármálafyrirtækja
fjármálaráherra	fjármálaráðherra
fjármálaætlun	fjármálaáætlun
fjárs	fjár
fjársins	fjárins
fjærri	fjarri
fjóran	fjóra
fjórfallt	fjórfalt
fjórtan	fjórtán
fjóru	fjórum
fjórðunginum	fjórðungnum
fjögura	fjögurra
Fjölb	Fjölb.
fjölbreyttni	fjölbreytni
fjöldan	fjöldann
fjölmiðillin	fjölmiðillinn
fjölmiðlu	fjölmiðlum
Fjölskylan	Fjölskyldan
fjölskylduföðursins	fjölskylduföðurins
fjölskyldumeðliminum	fjölskyldumeðlimnum
fjömiðlum	fjölmiðlum
fjörtíu	fjörutíu
fjöðurin	fjöðrin
flandsfélagið	aflandsfélagið
fleir	fleiri
fleirra	fleira
fleirri	fleiri
fleri	fleiri
flesti	flestir
fljúgjandi	fljúgandi
flokkin	flokkinn
flokkins	flokksins
flokkinum	flokknum
floksins	flokksins
Florída	Flórída
flugfélagins	flugfélagsins
flugvell	flugvelli
flugvélaginu	flugfélaginu
flugvélagsins	flugfélagsins
flugvélinu	flugfélaginu
flugvöllin	flugvöllinn
fluttning	flutning
Flygering	Flygenring
flyja	flýja
Flórdía	Flórída
Flórida	Flórída
flótt	fljótt
flóttamannastrauminum	flóttamannastraumnum
flúga	fljúga
flýa	flýja
flýji	flýi
fme	FME
fnr	fnr.
fokkin	fokking
folksins	fólksins
fomaður	formaður
foresti	forseti
formúgu	formúu
Fornite	Fortnite
forrystu	forystu
forrystuna	forystuna
forráðarmenn	forráðamenn
forsaetisraduneyti	forsætisráðuneyti
forsetakosningana	forsetakosninganna
forsetakosningnunum	forsetakosningunum
forsv.m.	forsvm.
forsytu	forystu
forsætirsráðherra	forsætisráðherra
forsætisráherra	forsætisráðherra
forsætisráðhera	forsætisráðherra
forsætisráðherran	forsætisráðherrann
forsætisráðherrra	forsætisráðherra
forsætsiráðherra	forsætisráðherra
forsætsráðherra	forsætisráðherra
fotbolti	fótbolti
foyrstu	forystu
foystu	forystu
fra	frá
Frabær	Frábær
Frakkklandi	Frakklandi
framboðsliðsta	framboðslista
framhalldið	framhaldið
framherjan	framherjann
framistöðu	frammistöðu
framkvæmdasstjóri	framkvæmdastjóri
framleiðandum	framleiðandanum
framlengarinnar	framlengingarinnar
framlenginu	framlengingu
framlenginunni	framlengingunni
framm	fram
framn	framan
Framsóknarflokkins	Framsóknarflokksins
Framsóknarflokkinum	Framsóknarflokknum
framtið	framtíð
framvæmdastjóri	framkvæmdastjóri
franskal	franska
fraumraun	frumraun
frettir	fréttir
Freya	Freyja
fri	frí
Fridriksdottir	Friðriksdóttir
Fridriksson	Friðriksson
frir	frír
friðhelgis	friðhelgi
friðlísing	friðlýsing
friðnum	friðinum
friðs	friðar
Frj	Frj.
frjálsyndi	frjálslyndi
frkvstj	frkvstj.
frma	fram
frmaboðs	framboðs
Frumv	Frumv.
frv	frv.
Frv	Frv.
frátaldri	frátalinni
frægann	frægan
fræum	fræjum
fréttastofunar	fréttastofunnar
fréttatilkyningu	fréttatilkynningu
fréttatofu	fréttastofu
fréttirnir	fréttirnar
Fróðarheiði	Fróðárheiði
ftir	eftir
fulljóst	fullljóst
fullnægji	fullnægi
fullorðina	fullorðinna
fullsaddann	fullsaddan
fulltrúm	fulltrúum
fundarinns	fundarins
fygjast	fylgjast
fygljast	fylgjast
fyir	fyrir
fyirir	fyrir
fyirr	fyrir
fylgast	fylgjast
fylgjst	fylgjast
fyr	fyrir
fyr	fyrr
fyrirgefiði	___
fyriri	fyrir
fyrirsætnana	fyrirsætnanna
fyrirtæja	fyrirtækja
fyrirtækins	fyrirtækisins
fyrirtækjana	fyrirtækjanna
fyrirtæksins	fyrirtækisins
fyrirtæksisins	fyrirtækisins
fyrirverandi	fyrrverandi
fyriræki	fyrirtæki
fyrirækja	fyrirtækja
fyrrir	fyrir
fyrrv	fyrrv.
fyrs	fyrst
fyrsa	fyrsta
fyrverandi	fyrrverandi
fyst	fyrst
fysta	fyrsta
fystu	fyrstu
fámennsta	fámennasta
fáranleikans	fáránleikans
fæturnar	fæturna
féi	fé
fék	fékk
félagins	félagsins
Félagsvísindast	Félagsvísindast.
félgar	félagar
félgasins	félagsins
félst	féllst
fésbókasíðu	fésbókarsíðu
Fídji	Fídjí
Fíh	FÍH
fítus	fídus
fóbolta	fótbolta
fók	fólk
fóki	fólki
fókin	flókin
fólinsýru	fólínsýru
fórnarlambana	fórnarlambanna
fótana	fæturna
fös	fös.
Fös	Fös.
föðurs	föður
föðursins	föðurins
gafa	gaf
gagnvar	gagnvart
gagvart	gagnvart
Galatasary	Galatasaray
Galleri	Gallerí
gamal	gamall
Gamal	Gamall
gamali	gamli
gamalsdags	gamaldags
gamanið	gamnið
Gamanið	Gamnið
gangrýnd	gagnrýnd
gangrýndi	gagnrýndi
gangrýndur	gagnrýndur
gangrýni	gagnrýni
gangrýnir	gagnrýnir
gangrýnt	gagnrýnt
gangvart	gagnvart
Garðarbæ	Garðabæ
Garðarbæjar	Garðabæjar
Garðarson	Garðarsson
Garðarsyni	Garðarssyni
Garðasson	Garðarsson
geg	gegn
gegnst	gengst
gegnur	gengur
gegum	gegnum
geiminum	geimnum
geist	geyst
geiða	greiða
gekki	gekk
gengdi	gegndi
gengdu	gegndu
gengt	gegnt
Georgiu	Georgíu
gerfi	gervi
geriða	greiða
gestana	gestanna
getiru	getirðu
geturu	geturðu
geysar	geisar
geysað	geisað
geysaði	geisaði
geðheilbrigðis	geðheilbrigði
Gissuradóttir	Gissurardóttir
Gissurason	Gissurarson
gjöreyðilagri	gjöreyðilagðri
glimmrandi	glimrandi
Glitins	Glitnis
gluggan	gluggann
glyfosat	glýfosat
glóðurauga	glóðarauga
glútein	glúten
glúteinlaust	glútenlaust
Golfstrauminum	Golfstraumnum
gonguhopur	gönguhópur
grata	gráta
greinni	greininni
greinninni	greininni
greiðsluþáttöku	greiðsluþátttöku
grendinni	grenndinni
grenslast	grennslast
Grimsson	Grímsson
Grindvaík	Grindavík
griðarstað	griðastað
griðarstaðir	griðastað
griðarstaður	griðastaður
griðarsvæði	griðasvæði
griðarsvæðis	griðasvæðis
gráturs	grátur
gróðrastía	gróðrarstía
gróðrastöð	gróðrarstöð
gróðurhúsalofftegunda	gróðurhúsalofttegunda
Gudmundson	Guðmundsson
Gudmundsson	Guðmundsson
Gudmundur	Guðmundur
Gudrun	Guðrún
Guinnes	Guinness
Gunan	Gunna
Gunnarsdottir	Gunnarsdóttir
Guðfinnson	Guðfinnsson
Guðfinsson	Guðfinnsson
Guðjónsen	Guðjohnsen
Guðjónss	Guðjónss.
Guðmundir	Guðmundur
Guðmunds	Guðmundar
Guðmundsdótir	Guðmundsdóttir
Guðmundssson	Guðmundsson
Guðmunsdóttir	Guðmundsdóttir
Guðn	Guðni
Guðrun	Guðrún
gæjinn	gæinn
gækvöldi	gærkvöldi
gæri	gæti
gæsluvarhaldi	gæsluvarðhaldi
gékk	gekk
gíslinu	gíslingu
Gólíat	Golíat
göfgastur	göfugastur
gömu	gömlu
Gönu	Gana
Gúam	Gvam
hafað	hafa
Hafnarstæti	Hafnarstræti
hafo	hafi
hafð	hafði
hagræðingur	hagfræðingur
Hakon	Hákon
Haldiði	___
Halldorsson	Halldórsson
Halldórson	Halldórsson
Hallgrimur	Hallgrímur
hamingu	hamingju
han	hann
hanbolta	handbolta
handók	handtók
hanns	hans
harnað	harðnað
Harrisson	Harrison
Harðadóttir	Harðardóttir
Harðarsson	Harðarson
hashtaginu	kassmerkinu
Haukssson	Hauksson
haustinn	haustin
haustins	haustsins
Havanna	Havana
Havard	Harvard
hdl	hdl.
Hdl	Hdl.
hefu	hefur
hefuru	hefurðu
hefðbunda	hefðbundna
hefðbundar	hefðbundnar
hegðunnar	hegðunar
heibrigðisráðherra	heilbrigðisráðherra
heilbrigðisþjónstu	heilbrigðisþjónustu
heimildi	heimildir
heimilidir	heimildir
Heimilisfriðs	Heimilisfriðar
heimilsfang	heimilisfang
heimilsofbeldi	heimilisofbeldi
heimli	heimili
Helsinborg	Helsingborg
helv	helv.
hengu	héngu
henn	henni
Henn	Henni
hennir	henni
Herdis	Herdís
hestins	hestsins
heðan	héðan
heðgun	hegðun
Heðin	Héðin
hgl	hgl.
highliter	highlighter
Himalayafjöllum	Himalajafjöllum
hing	hring
hinga	hingað
hinns	hins
hinsegins	hinsegin
hiphopi	hipphoppi
hiphoppi	hipphoppi
hiphopsins	hipphoppsins
hittst	hist
hja	hjá
Hjalmar	Hjálmar
hjalp	hjálp
Hjartarsson	Hjartarson
hjónband	hjónaband
Hjövar	Hjörvar
hjúkrunarfrædingur	hjúkrunarfræðingur
hjúkrunarheimilsins	hjúkrunarheimilisins
hkd	hkd.
hlutafe	hlutafé
hluterk	hlutverk
hluverk	hlutverk
hlýtar	hlítar
hneysa	hneisa
hnéi	hné
hnéinu	hnénu
hnéið	hnéð
hollusthætti	hollustuhætti
Hondúrass	Hondúras
honm	honum
Hornarfirði	Hornafirði
hornspynu	hornspyrnu
Hrd	Hrd.
hrellti	hrelldi
hringin	hringinn
hrl	hrl.
hryðjuverkaáras	hryðjuverkaárás
hryðjuverkaárasum	hryðjuverkaárásum
Hróaskeldu	Hróarskeldu
Hsu	HSu
Hugsins	Hugins
hundað	hundrað
hundruða	hundraða
hundruði	hundruð
hundruðir	hundruð
hunduð	hundruð
hungraðari	hungraðri
Huston	Houston
huta	hluta
huti	hluti
huxa	hugsa
huxi	hugsi
hva	hvar
hvassvirði	hvassviðri
hvassvirðri	hvassviðri
hvaðann	hvaðan
hvenig	hvernig
hverngi	hvernig
hverni	hvernig
hverning	hvernig
hvernir	hvernig
hverstu	hversu
hveru	hversu
hvirfilbyli	hvirfilbylji
hvorutveggja	hvort tveggja
hvða	hvað
hyggðist	hygðist
hyggðust	hygðust
hyglt	hyglað
Hysing	Hýsing
háannartíma	háannatíma
háflleik	hálfleik
Hákons	Hákonar
Hálfdáns	Hálfdánar
hálfeikinn	hálfleikinn
hálfeiknum	hálfleiknum
hálfeiks	hálfleiks
hálftíman	hálftímann
hállfeik	hálfleik
hátið	hátíð
hátiðina	hátíðina
hátiðinni	hátíðinni
hátíðinnar	hátíðarinnar
hæstarréttardómari	hæstaréttardómari
hæstaréttadómara	hæstaréttardómara
hæstaréttalögmaður	hæstaréttarlögmaður
Hæstarétts	Hæstaréttar
Hæstaréttur	Hæstiréttur
Hæstiréttar	Hæstaréttar
hæstlaunuðustu	hæstlaunuðu
héllt	hélt
Hérðasdómi	Héraðsdómi
héðann	héðan
hópinum	hópnum
Hórmóna	Hormóna
Hórmónar	Hormónar
höfu	höfum
höfuborgarsvæðinu	höfuðborgarsvæðinu
höfuðborgarsvæð	höfuðborgarsvæði
höfuðborgarsvæðinsins	höfuðborgarsvæðisins
höfuðborgarsvæðsins	höfuðborgarsvæðisins
höfuðu	höfðu
höfuðuð	höfðuð
höfðuborg	höfuðborg
höfðuborgarsvæðinu	höfuðborgarsvæðinu
höfðuborgarsvæðisins	höfuðborgarsvæðisins
höfðuðborgarsvæðinu	höfuðborgarsvæðinu
höllinn	höllin
hönnuðurnir	hönnuðirnir
húsakosts	húsakostar
húsins	hússins
hússin	hússins
Húta	Hútúa
húta	Hútúa
Hútar	Hútúar
Hútum	Hútúum
i	í
ifir	yfir
ign	Sign
ikea	Ikea
inann	innan
Indonesíu	Indónesíu
Ingbjörg	Ingibjörg
Ingimundarsson	Ingimundarson
Inglourious	Inglorious
innann	innan
innanrikisradherra	innanríkisráðherra
innanrikisraduneyti	innanríkisráðuneyti
innblástri	innblæstri
innbyrgðis	innbyrðis
innflytendur	innflytjendur
innflytjendmál	innflytjendamál
innhélt	innihélt
inniviði	innviði
innlutningi	innflutningi
innnan	innan
innsk.blm	innsk.blm.
innsyglaði	innsiglaði
innviðauppbygginu	innviðauppbyggingu
Instgram	Instagram
Instragram	Instagram
inum	einum
Isavía	Isavia
isl	ísl.
Isl	Ísl.
islam	íslam
islamista	íslamista
islams	íslams
Islandi	Íslandi
itl	til
iðnám	iðnnám
jafnfram	jafnframt
Jafnfram	Jafnframt
jafnramt	jafnframt
Jafnramt	Jafnframt
jafntefi	jafntefli
jafntelfi	jafntefli
jafvel	jafnvel
Jak	Jak.
jamt	jafnt
janframt	jafnframt
Janiero	Janeiro
jarðgangnagerð	jarðgangagerð
jarðskjáfta	jarðskjálfta
Jerúsalems	Jerúsalem
Johanna	Jóhanna
Johannes	Jóhannes
Johannesar	Jóhannesar
Johanns	Jóhanns
Johönnu	Jóhönnu
Joi	Jói
Jonköpings	Jönköpings
Jonsdottir	Jónsdóttir
Jorunn	Jórunn
judgment	judgement
Juillard	Juilliard
jur	jur.
Jésú	Jesú
Jóh	Jóh.
Jóhanesson	Jóhannesson
Jóhanneson	Jóhannesson
Jóhannson	Jóhannsson
Jóhannsonar	Jóhannssonar
Jóhannssson	Jóhannsson
Jóhannsyni	Jóhannssyni
Jóhansson	Jóhannsson
Jóhanssonar	Jóhannssonar
Jómfrúreyja	Jómfrúaeyja
Jómfrúreyjar	Jómfrúaeyjar
Jómfrúreyjarnar	Jómfrúaeyjarnar
Jómfrúreyjum	Jómfrúaeyjum
jómfrúreyjum	Jómfrúaeyjum
Jómfrúreyjunum	Jómfrúaeyjunum
Jónson	Jónsson
Jónss	Jónss.
jög	mjög
jölbreytt	fjölbreytt
jölmiðlafulltrúi	fjölmiðlafulltrúi
júni	júní
Júpiter	Júpíter
Júpiters	Júpíters
kafbátarins	kafbátsins
kafbátinum	kafbátnum
Kalforníu	Kaliforníu
Kalingrad	Kalíníngrad
Kalinigrad	Kalíníngrad
Kalíforníu	Kaliforníu
Kamerúns	Kamerún
kandadíska	kanadíska
kandidat	kandídat
kannksi	kannski
kannsi	kannski
kannske	kannski
kanntinum	kantinum
kanski	kannski
Karabíahafinu	Karíbahafinu
karaókí	karókí
Kardahsian	Kardashian
Kardasian	Kardashian
Kareni	Karenu
karkater	karakter
karmelliseruðum	karamellíseruðum
Karolínuríki	Karólínuríki
Karíbaeyja	Karíbahafseyja
karíókí	karókí
Karólinska	Karólínska
Karótínóíðin	Karótenóíðin
Kashmír	Kasmír
Katalónu	Katalóníu
Katars	Katar
katastrofía	katastrófa
Katrin	Katrín
Katrinu	Katrínu
Katrí	Katrín
Kauphöllinna	Kauphöllina
Kavananaugh	Kavanaugh
kef	Kef.
Kef	Kef.
Keflvík	Keflavík
Kellog	Kellogg
Kellogs	Kelloggs
kellíngar	kerlingar
kemru	kemur
kemu	kemur
Kenedy	Kennedy
keppendanni	keppendanna
keppinauti	keppinaut
keppnarinnar	keppninnar
keppninar	keppninnar
keppnini	keppninni
keppninna	keppninnar
keppnis	keppnin
keppnnisdagurinn	keppnisdagurinn
kept	keppt
Khasoggi	Khashoggi
kilómetra	kílómetra
kirkjunar	kirkjunnar
Kjartanss	Kjartanss.
Kjarvalstöðum	Kjarvalsstöðum
kjellingar	kerlingar
Kjobenhavn	Kobenhavn
kjurr	kyrr
kjurrt	kyrrt
kjóli	kjól
kjöfar	kjölfar
Kjörd	Kjörd.
kkert	ekkert
kki	ekki
klarinett	klarínett
klarinettu	klarínettu
klassikin	klassíkin
klerknum	klerkinum
klst	klst.
klukan	klukkan
klukkann	klukkan
klukkkan	klukkan
klukkkustund	klukkustund
klukkstund	klukkustund
klukkstundir	klukkustundir
klukktíma	klukkutíma
klukkustundur	klukkustundir
klínik	klíník
Klíníkinnar	___
knattpsyrnu	knattspyrnu
knattpyrnu	knattspyrnu
Knattpyrnusambands	Knattspyrnusambands
knattspynu	knattspyrnu
koltvísirings	koltvísýrings
koltvísiringsmengun	koltvísýringsmengun
komar	koma
komas	komast
kominr	kominn
komiði	___
komsat	komast
komð	komið
konunar	konunnar
konungfjölskyldunni	konungsfjölskyldunni
konuninni	konunni
konunna	konuna
korselett	korsilett
kosingar	kosningar
kosnina	kosninga
kosningana	kosninganna
kosningarett	kosningarétt
Kosningaþáttaka	Kosningaþátttaka
kosningnum	kosningunum
kosninum	kosningum
Kosovó	Kósóvó
Kostkó	Costco
kostnaðarþáttöku	kostnaðarþátttöku
Kosts	Kostar
kosts	kostar
Kosóvó	Kósóvó
krafnir	krafðir
kraftir	krafti
krefist	krefjist
kreystið	kreistið
KRinga	KR-inga
KRingar	KR-ingar
Kringluni	Kringlunni
Kringumýrarbraut	Kringlumýrarbraut
krinum	kringum
Kristanstad	Kristianstad
Kristiandstad	Kristianstad
Kristindóttir	Kristinsdóttir
Kristinsd	Kristinsd.
Kristinu	Kristínu
Kristjan	Kristján
Kristíaníu	Kristjaníu
Kristóferi	Kristófer
krona	króna
Krona	Króna
krossin	krossinn
krufningsskýrslu	krufningsskýrslu
krunarfræðingur	hjúkrunarfræðingur
Krístin	Kristín
Krístínu	Kristínu
krónar	krónur
krónunar	krónunnar
Krótatíu	Króatíu
Krótíu	Króatíu
kröfugt	kröftugt
KSí	KSÍ
kukkan	klukkan
kumaður	ökumaður
kunngt	kunnugt
kvar	hvar
kvennana	kvennanna
kvenær	hvenær
kversu	hversu
kvk	kvk.
kvold	kvöld
kvort	hvort
kvunndagshetja	hvunndagshetja
kvínna	kvína
kvöd	kvöld
kvöldins	kvöldsins
kynbundis	kynbundins
kynferðsbrot	kynferðisbrot
kynjahlutföllinn	kynjahlutföllin
kynjana	kynjanna
Kyrgistan	Kirgistan
kílovolta	kílóvolta
kílómeter	kílómetri
kílómeters	kílómetra
kítast	kýtast
kólestrólið	kólesterólið
Kólombíu	Kólumbíu
kórarninum	Kóraninum
kóreumanna	Kóreumanna
kóreumenn	Kóreumenn
kóriander	kóríander
kóríanderið	kóríanderinn
Kósavó	Kósóvó
Kósovo	Kósóvó
Kósovóa	Kósóvóa
Kósóva	Kósóvóa
Kósóvar	Kósóvóar
kúarinnar	kýrinnar
kúltur	kúltúr
kúrdneskra	kúrdískra
Kúvaít	Kúveit
Kúveits	Kúveits
Kúvæt	Kúveit
LAkers	Lakers
landam	landam.
landbúnaðaráðherra	landbúnaðarráðherra
landgraedsluskyrsla	landgræðsluskýrsla
Landhelgisgæslunar	Landhelgisgæslunnar
landins	landsins
landinum	landinu
landisns	landsins
Landsbjörgu	Landsbjörg
landsleikjahlénu	landsleikjahléinu
landsliðsfyrirli	landsliðsfyrirliði
landsliðsinu	landsliðinu
Landspítalan	Landspítalann
Landspítalnum	Landspítalanum
Landsvirkjunnar	Landsvirkjunar
langreyð	langreyði
lasagnia	lasagna
lau	lau.
launahækkanna	launahækkana
launhækkanir	launahækkanir
launungamál	launungarmál
lavander	lavender
Laxnessi	Laxness
laxsins	laxins
legga	leggja
leggði	legði
legst	leggst
Leifstöð	Leifsstöð
leigenda	leigjenda
leihlutann	leikhlutann
leikatriðinum	leikatriðunum
leikhuta	leikhluta
leikinum	leiknum
leikjarins	leiksins
leikju	leikjum
leikluta	leikhluta
leikmen	leikmenn
leikmönum	leikmönnum
leikonan	leikkonan
leiksin	leiksins
leiktið	leiktíð
leiktíðinn	leiktíðin
lennti	lenti
leyddi	leiddi
leyta	leita
Libíu	Líbíu
Libýu	Líbíu
liggji	liggi
lika	líka
likt	líkt
liltu	litlu
limmósínu	limúsína
limmósínunni	limúsínunni
limósínu	limúsínu
litil	lítil
Livepool	Liverpool
Liveprool	Liverpool
liðan	líðan
liðinum	liðnum
liðisins	liðsins
liðisns	liðsins
ljosmynd	ljósmynd
ljáð	léð
ljáði	léði
llir	allir
lls	alls
llu	öllu
llum	öllum
lokakeppi	lokakeppni
lokst	loks
Lovre	Louvre
Lsh	LSH
lsh	LSH
ltr	ltr.
Lundúnar	Lundúna
Lundúnarbrú	Lundúnabrú
Lundúnarbúar	Lundúnabúar
Lundúnarfélaginu	Lundúnafélaginu
Lundúnarfélagið	Lundúnafélagið
Lundúnarháskóla	Lundúnaháskóla
Lundúnarliðin	Lundúnaliðin
Lundúnarliðinu	Lundúnaliðinu
Lundúnarlögreglan	Lundúnalögreglan
Lundúnarslag	Lundúnaslag
Lundúnarslaginn	Lundúnaslaginn
Lundúnarslagur	Lundúnaslagur
Lundúni	Lundúnir
lungan	lungann
lykilatrið	lykilatriði
láu	lágu
lækin	lækinn
læksins	lækjarins
léta	lét
líkamsrárás	líkamsárás
líkamsáras	líkamsárás
líkega	líklega
líkuðu	líkaði
líter	lítra
líterinn	lítrinn
lítin	lítinn
lögrega	lögregla
lögreglunar	lögreglunnar
lögreglunna	lögregluna
lögregu	lögreglu
lögregunni	lögreglunni
lögrelan	lögreglan
lögrelgan	lögreglan
Lögrelgan	Lögreglan
lögrelgu	lögreglu
lögrelgunnar	lögreglunnar
lögrelgunni	lögreglunni
Löreglan	Lögreglan
lúnkinn	lunkinn
Lúsifer	Lúsífer
Lúxembourg	Lúxemborg
Lúxemburg	Lúxemborg
lúxús	lúxus
Lúðvíki	Lúðvík
lýðveldsins	lýðveldisins
m.a	m.a.
M.Ed	M.Ed.
m.kr	m.kr.
ma.kr	ma.kr.
MAdrid	Madrid
Madridinga	Madrídarbúa
Madridingar	Madrídarbúar
Madrídingar	Madrídarbúar
magnaðari	magnaðri
Magnusar	Magnúsar
Magnúsosn	Magnússon
Magnússo	Magnússon
mai	maí
majones	majónes
Majones	Majónes
majonesi	majónesi
Maldív	Maldívur
Managment	Management
Mangussen	Magnussen
Mangúsar	Magnúsar
mannin	manninn
manninnum	manninum
mannins	mannsins
Maradonna	Maradona
Marakkó	Marokkó
Margaretar	Margrétar
margfallt	margfalt
Margét	Margrét
Markusar	Markúsar
Marokkóar	Marokkómenn
Marokkóbúar	Marokkómenn
mart	margt
maríhúana	maríjúana
Marókko	Marokkó
Marókkó	Marokkó
matsk	matsk.
Maybellene	Maybelline
mað	að
meginn	megin
meginstefum	meginstefjum
megináskrifarleiða	megináskriftarleiða
meiga	mega
meigi	megi
meirihlutan	meirihlutann
meirilhuta	meirihlutann
Meistaradeildinnar	Meistaradeildarinnar
meistaram	meistaram.
Meistaramánuðar	Meistaramánaðar
meistaranir	meistararnir
meistaratitlinn	meistaratititilinn
Melabr	Melabr.
melantónín	melatónín
Meninga	Meniga
menntamálaráherra	menntamálaráðherra
menntunnar	menntunar
meria	meira
merksins	merkisins
Merkúríusar	Merkúrs
metar	metrar
meter	metri
meters	metra
Mexikó	Mexíkó
meða	meðan
meðatali	meðaltali
meðf	meðf.
meðferðarrúrræði	meðferðarúrræði
meðfylgandi	meðfylgjandi
meðl	meðal
meðtaldri	meðtalinni
meðvitaðara	meðvitaðra
meðvitaðari	meðvitaðri
mfl	mfl.
mgr	mgr.
Midtylland	Midtjylland
miki	mikið
mikila	mikla
mikili	mikilli
mikilir	miklir
mikilll	mikill
mikilllar	mikillar
mikillli	mikilli
mikillri	mikilli
mikilum	miklum
mikin	mikinn
miklli	mikilli
miklvægasta	mikilvægasta
miklvægt	mikilvægt
mikð	mikið
Milanó	Mílanó
milil	milli
millarða	milljarða
milligröm	milligrömm
millimeter	millimetri
millj	millj.
milljaðar	milljarðar
milljaðrar	milljarðar
milljaður	milljarður
milljonir	milljónir
milljóni	milljónir
milljónr	milljónir
millli	milli
millljarða	milljarða
millljarðar	milljarðar
millljónir	milljónir
millljónum	milljónum
millriðli	milliriðli
millígrömm	milligrömm
millímetra	millimetra
millímetrar	millimetrar
millímetrum	millimetrum
minimalistanum	mínimalistanum
minkað	minnkað
minns	minnst
Minouge	Minogue
minsta	minnsta
minu	mínu
minum	mínum
minútu	mínútu
minútur	mínútur
miskilningur	misskilningur
miskun	miskunn
miskunarlaust	miskunnarlaust
mismunadi	mismunandi
mismundi	mismunandi
misnoktun	misnotkun
misskilingur	misskilningur
Mistöð	Miðstöð
Miðafríkulýðveldinu	Mið-Afríkulýðveldinu
miðan	miðjan
miðjumannin	miðjumanninn
Mjanmars	Mjanmar
mjóg	mjög
Mjólkarbikarsins	Mjólkurbikarsins
mjör	smjör
mkið	mikið
mkr	m.kr.
mlb.is	mbl.is
Mmorgunblaðinu	Morgunblaðinu
Moldovía	Moldóva
Moldóvía	Moldóva
Moldóvíu	Moldóvu
Monakó	Mónakó
Montenegró	Svartfjallaland
Morgublaðinu	Morgunblaðinu
morgum	mörgum
Morgunblaðinnu	Morgunblaðinu
Morgunblaðinun	Morgunblaðinu
morgunin	morguninn
Morrisey	Morrissey
morteli	mortéli
morugn	morgun
Mosvka	Moskvu
Mosvku	Moskvu
mot	mót
moti	móti
Mourino	Mourinho
Mousaieff	Moussaieff
Moussaeiff	Moussaieff
mrd	mrd.
msk	msk.
mtt	m.t.t.
myndinn	myndinni
myndiru	myndirðu
myrkrana	myrkranna
málaflokkinum	málaflokknum
málfutningi	málflutningi
málins	málsins
málsl	málsl.
málínu	málinu
mán	mán.
Mán	Mán.
mánaðarsins	mánaðarins
mánuða	mánaða
mánuðar	mánaðar
mánuðnum	mánuðinum
mánuðu	mánuði
mægðurnar	mæðgurnar
Mæjorka	Majorka
mæjónes	majónes
mæjónesi	majónesi
mældis	mældist
mætst	mæst
mættast	mætast
míkrafóninn	míkrófóninn
míkrafóninum	míkrófóninum
Mílano	Mílanó
mínutu	mínútu
mínutum	mínútum
mínutur	mínútur
mínút	mínútu
mínútú	mínútu
mínútúr	mínútur
mðe	með
módir	móðir
mógða	móðga
mótins	mótsins
mótttöku	móttöku
mótttökur	móttökur
mótu	móti
mótórhjól	mótorhjól
mótórhjóli	mótorhjóli
móðirinn	móðirin
möguleikan	möguleikann
möguðustu	mögnuðustu
mörgun	mörgu
Múhammeð	Múhameð
Múltikúlti	Múltíkúltí
músik	músík
músikdögum	músíkdögu
Músikdögum	Músíkdögum
múslima	múslíma
múslimann	múslímann
múslimans	múslímans
múslimanum	múslímanum
múslimar	múslímar
múslimi	múslími
músliminn	múslíminn
múslimum	múslímum
n.k	nk.
n.t.t.	n.tt.
naktri	nakinni
Nathanealsson	Nathanaelsson
naugðun	nauðgun
neit	neitt
nemendi	nemandi
Nesk	Nesk.
neðanjarðarlestastöð	neðanjarðarlestarstöð
Nintento	Nintendo
Nitendo	Nintendo
niðurníslu	niðurníðslu
niðustaða	niðurstaða
niðustöðu	niðurstöðu
Nja	Njah
nnar	annar
nnum	mönnum
Nokkir	Nokkrir
nokkkuð	nokkuð
nokkri	nokkrir
nokkrun	nokkrum
nokkura	nokkurra
noktun	notkun
norksa	norska
norðann	norðan
Norðu	Norður
norðuhluta	norðurhluta
Norðurkóreumanna	Norður-Kóreumanna
Norðurkóreumenn	Norður-Kóreumenn
notk	notkun
Notthingham	Nottingham
nottla	náttúrulega
nu	nú
numer	númer
numu	námu
nánst	nánast
náttla	náttúrulega
nátturunni	náttúrunni
náttúrinni	náttúrunni
náttúrvernd	náttúruvernd
Náttúrvernd	Náttúruvernd
næringaþerapisti	næringarþerapisti
næststíðustu	næstsíðustu
næturklúbbinum	næturklúbbnum
næturna	næturnar
nér	né
Nígers	Níger
Nígeru	Nígeríu
níturbasa	niturbasa
nítíu	níutíu
nóv	nóv.
nóvembermánuðar	nóvembermánaðar
nún	núna
nútvitund	núvitund
nýa	nýja
nýan	nýjan
nýar	nýjar
nýasta	nýjasta
nýasti	nýjasti
nýji	nýi
nýjir	nýir
nýu	nýju
nýum	nýjum
o.fl	o.fl.
o.m.fl	o.m.fl.
o.s.	o.s.frv.
o.s.frv	o.s.frv.
o.sfrv.	o.s.frv.
o.sv.frv.	o.s.frv.
o.þ.h	o.þ.h.
oddiviti	oddviti
ofl	o.fl.
ofnin	ofninn
ofta	oftar
ogt	og
ohingya	Róhingja
Okei	Ókei
okei	ókei
okkkar	okkar
okkkur	okkur
okkru	nokkru
okku	okkur
okt	okt.
oktober	október
okóber	október
Olafsdottir	Ólafsdóttir
Olafson	Ólafsson
Olafur	Ólafur
olisdeildin	Olísdeildin
Olympíuleikunum	Ólympíuleikunum
onn	tonn
orkudrykksins	orkudrykkjarins
Orlandi	Orlando
Orlondo	Orlando
ormaður	formaður
orseti	forseti
orstöðumaður	forstöðumaður
oru	voru
osfr	o.s.frv.
osfrv	o.s.frv.
oslaegt	óslægt
Oslóarháskóla	Óslóarháskóla
Oslóartrénu	Óslóartrénu
Oslóartréð	Óslóartréð
Oslóborgar	Óslóarborgar
Ossur	Össur
Ottóson	Ottósson
oxýkódón	oxýkódon
oðið	orðið
panamíska	panamska
panamísku	panömsku
panik	panikk
Panik	Panikk
papríkuduft	paprikuduft
Paradis	Paradís
Parkinsonsjúkdóminn	Parkinsonssjúkdóminn
Parkison	Parkinsons
Patroits	Patriots
Pekíng	Peking
pelsi	pels
pennan	pennann
Pennsilvaníu	Pennsylvaníu
pensillín	pensilín
Pensilvaníu	Pennsylvaníu
Pensylvaníu	Pennsylvaníu
pepperóni	pepperóní
Pepsmörkin	Pepsimörkin
Pepsídeildarinnar	Pepsideildarinnar
Pepsídeildina	Pepsideildina
Pepsímörkununum	Pepsimörkunum
persónupplýsingar	persónuupplýsingar
Petur	Pétur
Peugot	Peugeot
Pheobe	Phoebe
Pheonix	Phoenix
Philadelpha	Philadelphia
Pintrest	Pinterest
Pirata	Pírata
Pistorious	Pistorius
PjongJang	Pjongjang
Platón	Plató
pligt	plikt
plötunar	plötunnar
populisma	popúlisma
populismi	popúlismi
populisti	popúlisti
Portúgalir	Portúgalar
Praag	Prag
pragt	prakt
praxis	praxís
Proppe	Proppé
próent	prósent
prógrami	prógrammi
prógramið	prógrammið
prósen	prósent
prósnet	prósent
Puertó	Púertó
pólítik	pólitík
pólítísk	pólitísk
pólítískar	pólitískar
pólítískir	pólitískir
pólítískri	pólitískri
pólítískt	pólitískt
Púerto	Púertó
Púrtó	Púertó
Rabbabara	Rabbarbara
radherra	ráðherra
rafmangs	rafmagns
Ragheiður	Ragnheiður
ram	fram
ramkvæmdastjóri	framkvæmdastjóri
rammpólítísk	rammpólitísk
rannska	rannsaka
rannsóknasetur	rannsóknarsetur
rasskelltir	rassskelltir
rauninn	raunin
raunni	rauninni
raunninni	rauninni
raunveruleikan	raunveruleikann
rað	ráð
Reglurgerðir	Reglugerðir
reikningin	reikninginn
reindar	reyndar
reitarbolta	reitabolta
reksti	rekstri
reksturins	rekstrarins
Republikana	Repúblikana
Repúblikanir	Repúblikanar
Repúblíkana	Repúblikana
repúblíkana	repúblikana
Repúblíkanaflokknum	Repúblikanaflokknum
Repúblíkanaflokksins	Repúblikanaflokksins
Repúblíkanar	Repúblikanar
repúblíkanar	repúblikanar
Repúblíkönum	Repúblikönum
resktur	rekstur
Reyjavík	Reykjavík
Reyjavíkur	Reykjavíkur
Reykajvík	Reykjavík
Reykajvíkur	Reykjavíkur
Reykavík	Reykjavík
Reykavíkur	Reykjaíkur
Reykavíkurborg	Reykjavíkurborg
Reykjavi	Reykjavík
Reykjavíkjurkjördæmi	Reykjavíkurkjördæmi
Reykjavíku	Reykjavíkur
Reykjavíkuborgar	Reykjavíkurborgar
Reykjvík	Reykjavík
Reykjvíkur	Reykjavíkur
Reykv	Reykv.
reysa	reisa
rfam	áfram
Riddu	Ríddu
rifildi	rifrildi
rigninu	rigningu
ringdi	rigndi
risaskjám	risaskjáum
ristjóra	ritstjóra
ristjóri	ritstjóri
ristjórn	ritstjórn
ritsjóri	ritstjóri
rivíerunni	Rivíerunni
riðili	riðli
Rió	Ríó
rohingja	róhingja
Rohingja	Róhingja
Rohingjafólkið	róhingjafólkið
rohingjafólkið	róhingjafólkið
rohingjana	róhingjana
rohingjanna	róhingjanna
rohingjarnir	róhingjarnir
Rohingjum	Róhingjum
rohingjum	róhingjum
rohingjunum	róhingjunum
rskurðarnefnd	úrskurðarnefnd
Rvk	Rvk.
rátt	átt
ráðgjafastöð	ráðgjafarstöð
ráðherran	ráðherrann
Ráðherran	Ráðherrann
ráðherrra	ráðherra
ráðst	ráðist
ráðu	ráðum
réttt	rétt
ríkisfyrirækja	ríkisfyrirtækja
ríkisns	ríkisins
ríkissins	ríkisins
ríkissjónvarpssins	ríkissjónvarpsins
ríkissjórn	ríkisstjórn
ríkisskattsjóra	ríkisskattstjóra
ríkissstjórn	ríkisstjórn
ríkisstj	ríkisstj.
ríkisstjórnarinar	ríkisstjórnarinnar
ríkisstjórnarninnar	ríkisstjórnarinnar
ríkisstjórninn	ríkisstjórnin
ríkisstjóðs	ríkissjóðs
ríkisstórn	ríkisstjórn
ríkistjórn	ríkisstjórn
ríkistjórnar	ríkisstjórnar
ríkistjórnarinnar	ríkisstjórnarinnar
ríkistjórnin	ríkisstjórnin
ríkistjórnina	ríkisstjórnina
ríkistjórninni	ríkisstjórninni
Ríko	Ríkó
ríksins	ríkisins
ríksisins	ríkisins
ríksstjórn	ríkisstjórn
Río	Ríó
Ríveríunni	Rivíerunni
ríveríunni	Rivíerunni
róhingja	róhingja
róhingjum	róhingjum
Rómarveldis	Rómaveldis
Rúrík	Rúrik
Rússeska	Rússneska
rússibana	rússíbana
rússibanareið	rússíbanareið
rússibani	rússíbani
rútinni	rútunni
rúv	RÚV
rýmar	rúmar
s.k.	sk.
s.l	sl.
s.l.	sl.
s.s	s.s.
S.þ.	S.Þ.
safnins	safnsins
sagð	sagði
sagðu	sagði
sagðí	sagði
salek	SALEK
Salomón	Salómon
samastendur	samanstendur
Sameiginl	Sameiginl.
sameingingarhugmyndir	sameiningarhugmyndir
sameiningaviræður	sameiningarviðræður
Sameinðu	Sameinuðu
samfélagins	samfélagsins
samfó	Samfó
Samgöngstofa	Samgöngustofa
samhyggð	samhygð
saming	samning
samingi	samningi
samingnum	samningnum
samingum	samningum
Samingur	Samningur
Samingurinn	Samningurinn
samingurinn	samningurinn
Samkeppniseftirlitins	Samkeppniseftirlitsins
samkomlagi	samkomulagi
samkynhneiðra	samkynhneigðra
samn	saman
samningins	samningsins
samninginum	samningnum
samstarfssaming	samstarfssamning
samstað	samstaða
Samsun	Samsung
samtakana	samtakanna
Samtakana	Samtakanna
samtakann	samtakanna
samtarf	samstarf
samtarfi	samstarfi
samtöðu	samstöðu
Samvkæmt	Samkvæmt
samvkæmt	samkvæmt
samvæmt	samkvæmt
Samvæmt	Samkvæmt
samþykja	samþykkja
sanngirnis	sanngirni
sanngjart	sanngjarnt
sannleikan	sannleikann
Sarpnum	Sarpinum
Sauda	Sádi-Araba
saðgi	sagði
sbr	sbr.
seglinn	seglin
segri	segir
seigr	segir
seir	segir
sekann	sekan
Selfos	Selfoss
selsíus	Celsíus
Seltjarnanesi	Seltjarnarnesi
Seltjarnesi	Seltjarnarnesi
Seltyrningar	Seltirningar
sendirherra	sendiherra
sentimeter	sentimetri
senunna	senuna
sepember	september
sept	sept.
septemer	september
seríos	seríós
sexý	sexí
sgaði	sagði
sgeir	segir
sgir	segir
Shanghaí	Sjanghaí
Shanghæ	Sjanghaí
sharía	sjaría
sherpar	sjerpar
sherpinn	sjerpinn
shía	sjía
Shía	Sjía
sifjaspells	sifjaspella
Sigmunds	Sigmundar
Signy	Signý
Sigriður	Sigríður
sigru	sigur
Sigthorsson	Sigþórsson
Sigurdson	Sigurðsson
Sigurjon	Sigurjón
Sigurjonsson	Sigurjónsson
sigurreyfur	sigurreifur
Sigurðarsdóttir	Sigurðardóttir
Sigurðarsson	Sigurðarson
Siguðrsson	Sigurðsson
Siguður	Sigurður
silgdi	sigldi
silgdu	sigldu
silgt	siglt
silvur	silfur
Simbave	Simbabve
Sinaí	Sínaí
Sinfoníuhljómsveitar	Sinfóníuhljómsveitar
Sirkús	Sirkus
sirkús	sirkus
Sirrýar	Sirrýjar
Siríus	Síríus
sitg	stig
sitgahæstur	stigahæstur
sitið	setið
siðasta	síðasta
siðu	síðu
siðustu	síðustu
sja	sjá
sjaldgjæf	sjaldgæf
sjaldgjæft	sjaldgæft
sjer	sér
Sjstfl	Sjstfl.
Sjálfstæðisflokkins	Sjálfstæðisflokksins
Sjálfstæðisflokkinum	Sjálfstæðisflokknum
Sjálfstæðisflokkkurinn	Sjálfstæðisflokkurinn
Sjálfstæðisflokksin	Sjálfstæðisflokksins
Sjálfstæðisflokkurin	Sjálfstæðisflokkurinn
Sjálfstæðislfokksins	Sjálfstæðisflokksins
Sjálfstæðsflokksins	Sjálfstæðisflokksins
sjálfsöðgu	sjálfsögðu
Sjálstæðisflokkurinn	Sjálfstæðisflokkurinn
sjéns	séns
sjítamúslíma	sjítamúslima
sjónvarpsskjám	sjónvarpsskjáum
sjónvarvotta	sjónarvotta
Sjónvarvottar	Sjónarvottar
sjónvarvottum	sjónarvottum
Sjónvarvottur	Sjónarvottur
sjónvarvottur	sjónarvottur
sjörnu	stjörnu
Sjúkrah	Sjúkrah.
sjúkralidi	sjúkraliði
skafað	skafið
skallotlaukar	skalottlaukar
skalottulaukar	skalottlaukar
skalottulaukur	skalottlaukur
skammst	skammast
skandínavísk	skandinavísk
skandínavíska	skandinavíska
skandínavískt	skandinavískt
skandínavískum	skandinavískum
Skandínavíu	Skandinavíu
skarlottlauk	skalottlauk
skattekjur	skatttekjur
skaðan	skaðann
skemmtigarðarins	skemmtigarðsins
skerðin	skerðing
skilaðboð	skilaboð
skilboð	skilaboð
skilboðum	skilaboðum
skilingur	skilningur
skilorðabundið	skilorðsbundið
skilt	skylt
skiptana	skiptanna
skiptst	skipst
skipulagingu	skipulagningu
Skipuleggendur	Skipuleggjendur
skipuleggendur	skipuleggjendur
skjaskot	skjáskot
skjáfti	skjálfti
skjáksot	skjáskot
skjám	skjáum
skonar	konar
skorðai	skoraði
skotáras	skotárás
skoðanakannanar	skoðanakönnunar
skoðanna	skoðana
skoðunnar	skoðunar
skoðunu	skoðunum
skrar	skrár
skriffinsku	skriffinnsku
skrýmsli	skrímsli
Skulason	Skúlason
skv	skv.
skytttur	skyttur
Skítseyðin	Skítseiðin
Skólahreystis	Skólahreysti
skólan	skólann
skýrlsu	skýrslu
skýrskotun	skírskotun
skýslu	skýrslu
slandi	Íslandi
slaðaðist	slasaðist
slenska	íslenska
slensku	íslensku
slenskum	íslenskum
slikt	slíkt
slikum	slíkum
slóu	slógu
slökkvliðinu	slökkviliðinu
slökkvliðið	slökkviliðið
sme	sem
smeikur	smeykur
Smáaugl	Smáaugl.
smör	smjör
snuðrulaust	snurðulaust
snýkjudýr	sníkjudýr
soleiðis	svoleiðis
solleis	svoleiðis
solleiðis	svoleiðis
sollis	svoleiðis
soyasósa	sojasósa
soyasósu	sojasósu
spagetti	spagettí
spenanndi	spennandi
Spigel	Spiegel
spilarnum	spilaranum
Spkef	SpKef
sprellifandi	sprelllifandi
sprenginu	sprengingu
spurja	spyrja
stafinu	starfinu
Standford	Stanford
Starfsfhópnum	Starfshópnum
Starfsfhópur	Starfshópur
starfsháttu	starfshætti
starfsmadur	starfsmaður
starfsmennn	starfsmenn
starfssemi	starfsemi
starsfmanna	starfsmanna
stax	strax
Steet	Street
Stefaniu	Stefaníu
Steinarrs	Steinars
Steinarrsdóttir	Steinarsdóttir
Steingrimsfjarðarheiði	Steingrímsfjarðarheiði
stendu	stendur
steng	streng
steypireyð	steypireyði
sti	stig
stija	sitja
stil	til
stjarnana	stjarnanna
stjón	stjórn
stjónvöld	stjórnvöld
stjóriðju	stóriðju
stjórmálaflokka	stjórnmálaflokka
stjórmálum	stjórnmálum
stjórnarmyndundarviðræður	stjórnarmyndunarviðræður
stjórnarskárinnar	stjórnarskráarinnar
stjórninn	stjórnin
stjórvöld	stjórnvöld
stjörnuanísar	stjörnuaníss
Stjörnunar	Stjörnunnar
stjörnunar	stjörnunnar
Stjörnunna	Stjörnuna
stjörnvöld	stjórnvöld
Stjörunni	Stjörnunni
stk	stk.
stml	stml.
stofandi	stofnandi
stofnunnarinnar	stofnunarinnar
stolltur	stoltur
stoðs	stoðs.
stressaðari	stressaðri
streytu	streitu
stráginn	strákinn
strúktur	strúktúr
stuðningmenn	stuðningsmenn
Stuðningmenn	Stuðningsmenn
stuðningmönnum	stuðningsmönnum
stykleikaflokkur	styrkleikaflokkur
styða	styðja
stærs	stærst
stætó	strætó
stórann	stóran
stórasta	stærsta
stórn	stjórn
Störnum	Stjörnum
stöðugari	stöðugri
Stúdío	Stúdíó
stúlknana	stúlknanna
stúlkunar	stúlkunnar
sumafrí	sumarfrí
sunnann	sunnan
sunndaginn	sunnudaginn
sunni	sinni
sutt	stutt
suttu	stuttu
suttum	stuttum
Suðurameríkukeppninni	Suður-Ameríkukeppninni
Suðurk	Suðurk.
svarði	svaraði
sveitarfélagins	sveitarfélagsins
sveitrafélag	sveitarfélag
svekkandi	svekkjandi
svf	svf.
svingsinn	sfinxinn
Sviþjóð	Svíþjóð
svokalla	svokallað
svoldið	svolítið
svon	svona
svooo	svo
svæðinum	svæðinu
svæðsins	svæðisins
Svínn	Svíinn
Svíðþjóð	Svíþjóð
Svíðþjóðar	Svíþjóðar
svö	svo
svökölluðu	svokölluðu
svöru	svörum
syntha	synþa
sæu	sæju
sæum	sæjum
sæust	sæjust
séfræðingur	sérfræðingur
séhæfðra	sérhæfðra
sérrý	sérrí
sérsmíður	sérsmíðaður
sérstak	sérstakt
sérstakega	sérstaklega
sérstækar	sértækar
síaðsta	síðasta
sídegis	síðdegis
sífelt	sífellt
síja	sjía
Síja	Sjía
sílikon	silíkon
Sílikon	Silíkon
sílikoni	silíkoni
Sílikons	Silíkons
sílikons	silíkons
Símons	Símonar
Síngapúr	Singapúr
sínni	sinni
sínur	sínum
sísvona	sisona
síðastlinn	síðastliðinn
síðastliði	síðastliðið
síðastliðinum	síðastliðnum
síðastu	síðustu
síðata	síðasta
síðsta	síðasta
síðstliðinn	síðastliðinn
síðstu	síðustu
síðsutu	síðustu
síðus	síðust
síðusta	síðasta
síðusut	síðustu
Sófakarteflan	Sófakartaflan
sólarhing	sólarhring
sólarmeginn	sólarmegin
sómalskan	sómalískan
sómalskir	sómalískir
Sómalskir	Sómalískir
sómalskur	sómalískur
sómað	sæmt
sómölsk	sómalísk
Sómölsk	Sómalísk
söfnunni	söfnuninni
sölunar	sölunnar
Sönkonan	Söngkonan
sönnungargögn	sönnunargögn
sönnungargögnum	sönnunargögnum
Súkkalaðikaka	Súkkulaðikaka
Súrheystrun	Súrheysturn
sýrlandsher	Sýrlandsher
sýst	síst
t.a.m	t.a.m.
t.d	t.d.
T.d	T.d.
tad	það
Tadjikistan	Tadsíkistan
Tadsíkistan	Tadsíkistan
takst	takt
Talverður	Talsverður
talverður	talsverður
tar	þar
taskna	taska
Tatörum	Töturum
tboði	tboði
td	t.d.
teki	tekið
tekjukatt	tekjuskatt
tekknó	teknó
tekð	tekið
telft	teflt
telj	telja
tengingnum	teningnum
tengls	tengsl
tenglsum	tengslum
teyja	teygja
Thailandi	Taílandi
Thailands	Taílands
Theadór	Theodór
Theodora	Theódóra
Thorodssen	Thoroddssen
thvi	því
tifellum	tilfellum
tikynningu	tilkynningu
tilhneygingu	tilhneigingu
tilkyningu	tilkynningu
tilkynninguni	tilkynningunni
tilkynnningu	tilkynningu
tillagana	tillaganna
tillkynningu	tilkynningu
tillliti	tilliti
tilllögu	tillögu
tilllögur	tillögur
tillögunar	tillögunnar
tiln	tiln.
tilraunverkefni	tilraunaverkefni
tilögunni	tillögunni
tima	tíma
timían	timjan
timíani	timjani
Tindr	Tinder
titilinum	titlinum
tið	tíð
tjáningarfrelsins	tjáningarfrelsisins
tjórn	stjórn
tjórnvöld	stjórnvöld
tli	til
tll	til
tok	tók
Tokýó	Tókýó
Tollskrárnr	Tollskrárnar
topinn	toppinn
Torinó	Tórínó
Torínó	Tórínó
toxoplasmi	toxóplasma
trajágrein	trjágrein
trampolíngarð	trampólíngarð
traustins	traustsins
Tripoli	Trípólí
Trykja	Tyrkja
tréin	trén
tréið	tréð
Trömsö	Tromsö
trúverðugari	trúverðugri
trúverðuleika	trúverðugleika
Tsjetsníu	Tsjetsjeníu
tsk	tsk.
tugthúsið	tukthús
Tump	Trump
Tungnárjökuls	Tungnaárjökuls
tungslins	tunglsins
tur	tug
turmerik	túrmerik
tuttuga	tuttugu
tuttugusta	tuttugasta
tvegga	tveggja
tveimir	tveimur
tvem	tveim
tvemur	tveimur
tvisar	tvisvar
tví	því
tvíelfdir	tvíefldir
tvöfallt	tvöfalt
tvölfalt	tvöfalt
tækvondo	taíkvondó
Téteníu	Tsjetsjeníu
Téténa	Tsjetsjena
Téténar	Tsjetsjenar
téténsku	tsjetsjensku
Téténía	Tsjetsjenía
Téténíu	Tsjetsjeníu
tíamtökuna	tímatökuna
tífallt	tífalt
tígrísdýr	tígrisdýr
tíl	til
tímabilð	tímabili
tímabundar	tímabundnar
tískuverðlaunana	tískuverðlaunanna
tíðindu	tíðindi
tógóískar	tógóskar
tóks	tókst
Tókíó	Tókýó
Tókíóborgar	Tókýóborgar
Tókýo	Tókýó
tómatpuré	tómatpúrra
tómatpúre	tómatpúrra
tómatpúré	tómatpúrra
tóskt	tókst
tóst	tókst
tölvert	töluvert
tölvuskjám	tölvuskjáum
töpudum	töpuðum
Túngumál	Tungumál
túnísku	túniskur
túrmeriki	túrmerik
Týrol	Týról
u.þ.b	u.þ.b.
umdaemin	umdæmin
umf	umf.
Umf	Umf.
umferði	umferðir
Umfjölllun	Umfjöllun
umfjöllunnar	umfjöllunar
umfjöllunni	umfjölluninni
umhverfisraduneyti	umhverfisráðuneyti
Umhverfisstofunar	Imhverfisstofnunar
umjöllun	umfjöllun
umskurðsbanni	umskurðarbanni
umsækendur	umsækjendur
undankeppi	undankeppni
undanskildri	undanskilinni
undartekning	undantekning
undibúningi	undirbúningi
undirbúing	undirbúning
undirbúningu	undirbúningur
undirtekir	undirtektir
undnafarin	undanfarin
Unversal	Universal
updráttar	uppdráttar
uppbygginu	uppbyggingu
uppbygingu	uppbyggingu
uppgvötun	uppgötvun
uppgvötvaði	uppgötvaði
upphýfingum	upphífingum
upplýsinar	upplýsingar
upplýsingaskjám	upplýsingaskjáum
upplýsinum	upplýsingum
upprunin	uppruninn
uppskirft	uppskrift
uppskrfit	uppskrift
uppýsingar	upplýsingar
uppýsingum	upplýsingum
ut	út
uta	utan
utanaðakomandi	utanaðkomandi
utann	utan
utanríksiráðherra	utanríkisráðherra
utanríksráðherra	utanríkisráðherra
utgafa	útgáfa
Utvortis	Útvortis
uþb	u.þ.b.
Valdis	Valdís
Valgardur	Valgarður
valkosts	valkostar
Valkosts	Valkostar
vallarsins	vallarins
vandaðari	vandaðri
vandmál	vandamál
vandmálið	vandamálið
varafli	varaafli
varformaður	varaformaður
varmarmaður	varnarmaður
varmaður	varamaður
Vatikaninu	Vatíkaninu
Vatikanið	Vatíkanið
Vegagerðarinar	Vegagerðarinnar
Vegagerðinnar	Vegagerðarinnar
vegn	vegna
veir	tveir
veirð	verið
veitingstaði	veitingastaði
veiðgjöld	veiðigjöld
vekji	veki
vekjir	vekir
venga	vegna
vennalandsliðið	kvennalandsliðið
verid	verið
verkefnsins	verkefnisins
verrra	verra
verðlaunafhendingarinnar	verðlaunaafhendingarinnar
verðlaunaféið	verðlaunaféð
verðlaunfé	verðlaunafé
verðuru	verðurðu
Vestfjarðar	Vestfjarða
Vestfjarðargöng	Vestfjarðagöng
Vestfjarðarkjálkanum	Vestfjarðakjálkanum
Vestfjarðarstofu	Vestfjarðastofu
Vestfjarðarveg	Vestfjarðaveg
Vestmananeyjum	Vestmannaeyjum
Vestmannaey	Vestmannaeyjar
Vestmannaeyjarferju	Vestmannaeyjaferju
Vestmannaeyjargosinu	Vestmannaeyjagosinu
Vestmanneyjum	Vestmannaeyjum
veturnar	veturna
veturs	vetrar
vetursins	vetrarins
vetvangi	vettvangi
vibótar	viðbótar
vid	við
Vidar	Viðar
videó	vídeó
Vigdis	Vigdís
Viglundsson	Víglundsson
Vihjálmur	Vilhjálmur
Viktoriu	Viktoríu
vikunar	vikunnar
Vilhjámsson	Vilhjálmsson
Vilhjámur	Vilhjálmur
viljan	viljann
vilta	villta
viltra	villtra
viltum	villtum
vinnumarkaðrins	vinnumarkaðarins
vinnunar	vinnunnar
Vinsti	Vinstri
vinsti	vinstri
vinstursins	vinstrisins
vinsældra	vinsælda
Virginu	Virginíu
Virgínu	Virginíu
virðst	virst
virðst	virðist
visvítandi	vísvitandi
viðali	viðtali
viðkurkenning	viðurkenning
viðkæma	viðkvæma
viðrbrögð	viðbrögð
Viðreisna	Viðreisnar
viðundandi	viðunandi
viðverandi	viðvarandi
Vlija	Vilja
vonbriðgum	vonbrigðum
vonbriði	vonbrigði
vopnaðara	vopnaðra
vorkun	vorkunn
Vouge	Vogue
vsk	vsk.
Vutton	Vuitton
vvl	vvl.
vændisstarfssemi	vændisstarfsemi
víbrator	víbrador
víkji	víki
vínýl	vínil
vítapsyrnu	vítaspyrnu
víðfem	víðfeðm
víðfemd	víðfeðm
víðfemdar	víðfeðmar
víðfemdir	víðfeðmir
víðfemdur	víðfeðmur
víðfemt	víðfeðmt
vði	við
völlin	völlinn
yfi	yfir
yfirýsingar	yfirlýsingar
yfr	yfir
yrir	fyrir
yrrverandi	fyrrverandi
yrsta	fyrsta
ábygð	ábyrgð
áfam	áfram
áfarm	áfram
áfarmhaldandi	áframhaldandi
áftur	aftur
ágætist	ágætis
ágætla	ágætlega
áhirf	áhrif
áhri	áhrif
ákv	ákv.
ákvarðanartöku	ákvörðunartöku
ákvarðnir	ákvarðanir
ákvaðanir	ákvarðanir
ákvaðu	ákváðu
ákvörun	ákvörðun
ákvörðu	ákvörðun
ákvörðunni	ákvörðuninni
ákvöðrun	ákvörðun
ákörðun	ákvörðun
ángæður	ánægður
ánnar	annar
ánægur	ánægður
áras	árás
áratuginum	áratugnum
áratugs	áratugar
áratugsins	áratugarins
árins	ársins
Árnasson	Árnason
ársfjórðunginum	ársfjórðungnum
árverkni	árvekni
árángur	árangur
árð	árið
ásam	ásamt
áskana	ásakana
áskanirnar	ásakanirnar
Ásmunds	Ásmundar
átakana	átakanna
átjan	átján
átjanda	átjánda
átjá	átján
ávaxtardrykkur	ávaxtadrykkur
ávörðun	ákvörðun
áðann	áðan
áðdáandi	aðdáandi
áðgjafi	ráðgjafi
æfina	ævina
Ægissdóttir	Ægisdóttir
ætl	ætli
ætlaru	ætlarðu
ættingum	ættingjum
ættiru	ættirðu
élag	félag
élagið	félagið
éljagagnur	éljagangur
étt	rétt
íBV	ÍBV
ÍBv	ÍBV
íbúm	íbúum
Íhaldsflokkinum	Íhaldsflokknum
Íkea	Ikea
íkið	ríkið
íkt	líkt
íllt	illt
Írakstríðinu	Íraksstríðinu
Ísam	ÍSAM
Ísavía	Isavia
ísl	ísl.
Ísl	Ísl.
ísl.kr.	ísl. kr.
Ísla	Ísland
Íslan	Ísland
Íslandsmeistar	Íslandsmeistari
Íslans	Íslands
ísle	Íslendingum
Íslendignar	Íslendingar
Íslendignur	Íslendingur
íslenka	íslenska
íslenksa	íslenska
Ísreal	Ísrael
Ítalarnir	Ítalir
Ítaliu	Ítalíu
Ítalí	Ítalíu
ítekað	ítrekað
ðalmeðferð	aðalmeðferð
ðan	áðan
ðað	að
óhemilt	óheimilt
óhullt	óhult
ÓIafur	Ólafur
ókeipis	ókeypis
Ólafia	Ólafía
ólani	óláni
ólk	fólk
Ólympíuleiknum	Ólympíuleikunum
ópíumi	ópíum
óreganói	óreganó
óstýrláti	óstýrilátri
Ótarr	Óttarr
Óttarri	Óttari
Óttarrs	Óttars
Óttarson	Óttarsson
óumflýjanleik	óumflýjanleika
óvissunar	óvissunnar
óviðundandi	óviðunandi
óöryggir	óöruggir
öflugara	öflugra
öflugari	öflugri
ögreglan	lögreglan
ögreglumenn	lögreglumenn
ögreglunni	lögreglunni
ökklan	ökklann
öldungardeild	öldungadeild
Öldungardeild	Öldungadeild
öldungardeildar	öldungadeildar
öldungardeildarinnar	öldungadeildarinnar
öldungardeildarþingmann	öldungadeildarþingmann
öldungardeildarþingmanna	öldungadeildarþingmanna
öldungardeildarþingmanni	öldungadeildarþingmanni
öldungardeildarþingmanns	öldungadeildarþingmanns
öldungardeildarþingmaðurinn	öldungadeildarþingmaðurinn
Öldungardeildarþingmaðurinn	Öldungadeildarþingmaðurinn
öldungardeildarþingmenn	öldungadeildarþingmenn
öldungardeildarþingmönnum	öldungadeildarþingmönnum
öldungardeildinni	öldungadeildinni
ölllu	öllu
ölllum	öllum
öllun	öllum
ölvunnar	ölvunar
örbrigð	örbirgð
örggum	öruggum
öryggan	öruggan
öryggir	öruggir
öryggt	öruggt
örðugara	örðugra
Össurrar	Össurar
Össurri	Össuri
öðruvísu	öðruvísi
Úkraníu	Úkraínu
Úkrænu	Úkraínu
Úlfarsársdal	Úlfarsárdal
Úlfarársdal	Úlfarsárdal
úrsiltum	úrslitum
úrskeðis	úrskeiðis
úrsl	úrsl.
úrslitakeppnini	úrslitakeppninni
Úrsula	Úrsúla
Úrugvæ	Úrúgvæ
úrvalsdeildnini	úrvalsdeildinni
úrvalseildinni	úrvalsdeildinni
Úrúgvæa	Úrúgvæja
Úrúgvæar	Úrúgvæjar
Úrúgvæum	Úrúgvæjum
útblástri	útblæstri
útjarðri	útjaðri
útjaður	útjaðar
útsendinu	útsendingu
útsjónasemi	útsjónarsemi
útttekt	úttekt
ýmissra	ýmissa
þ.e	þ.e.
þ.e.a.s	þ.e.a.s.
þ.m.t	þ.m.t.
þ.á	þ.á.
þanig	þannig
þanng	þannig
þanngað	þangað
þe	þ.e.
þea	þ.e.a.s.
þear	þegar
þeas	þ.e.a.s.
þei	þeir
þeira	þeirra
þeirar	þeirrar
þeiri	þeirri
þeirr	þeirra
þeirrra	þeirra
þeitta	þetta
þem	þeim
þenna	þennan
þennann	þennan
þennna	þennan
þer	þér
þes	þess
þesa	þessa
þesar	þessar
þesara	þessarra
þesari	þessari
þessarra	þessara
þessarrar	þessarar
þessarri	þessari
þessm	þessum
þessra	þessar
þessri	þessari
þesss	þess
þesssa	þessa
þesssu	þessu
þesum	þessum
þesus	þessu
Þett	Þetta
þett	þetta
þettta	þetta
Þettta	Þetta
þgear	þegar
þikir	þykir
þin	þín
þingins	þingsins
þingkosningnum	þingkosningunum
þjáfari	þjálfari
þjáflari	þjálfari
þjár	þrjár
þjófinum	þjófnum
þjónstu	þjónustu
þjónust	þjónustu
þjóðgarðarins	þjóðgarðsins
Þjóðhátið	Þjóðhátíð
þjóðhöfðinga	þjóðhöfðingja
þjú	þrjú
þo	þó
Þorkafjarðar	Þorskafjarðar
Þorkells	Þorkels
Þorkellsdóttir	Þorkelsdóttir
Þorl	Þorl.
Þorsteinssdóttir	Þorsteinsdóttir
þrautsegju	þrautseigju
þrefallt	þrefalt
þrettan	þrettán
þri	þri.
þrigga	þriggja
þriggjastiga	þriggja stiga
Þrir	Þrír
þrir	þrír
þriðjuhluta	þriðju hluta
þriðjuhlutar	þriðju hlutar
þrjatíu	þrjátíu
þrju	þrjú
þroskaðari	þroskaðri
þrufum	þurfum
Þrándarsson	Þrándarson
þrátíu	þrjátíu
Þróttr	Þróttur
þrú	þrjú
þu	þú
þurf	þurfi
þurfu	þurftu
þurt	þurrt
þvi	því
þvílikt	þvílíkt
þvíæ	því
þyggja	þiggja
þyrfi	þyrfti
þát	þátt
þáttaka	þátttaka
Þáttaka	Þátttaka
þáttakanda	þátttakanda
þáttakandann	þátttakandann
þáttakandans	þátttakandans
þáttakandanum	þátttakandanum
þáttakandi	þátttakandi
þáttakandinn	þátttakandinn
þáttakenda	þátttakenda
þáttakendanna	þátttakendanna
þáttakendum	þátttakendum
þáttakendunum	þátttakendunum
þáttakendur	þátttakendur
þáttakendurna	þátttakendurna
þáttakendurnir	þátttakendurnir
þáttöku	þátttöku
þættinu	þættinum
Þða	Það
Þórhallson	Þórhallsson
Þórlákshöfn	Þorlákshöfn
Þórmörk	Þórsmörk
Þórðarsson	Þórðarson
Þórðarssonar	Þórðarsonar
Þórðarssyni	Þórðarsyni
Þórðason	Þórðarson
Þórðs	Þórðar
þöggunnar	þöggunar
þús	þús.
þúsundur	þúsundir
Þýslalandi	Þýskalandi
